1111111111111111111111111111
1100000000000000000000000011
1100000000000000000000000011
1100000000000000000000000011
1100000000000000000000000011
1111110000000000000000000011
1111110000000000000000000011
1111110000000000000000000011
1111111111111111112200000011
1111111111111111112222000011
1111111111111111112222200011
1111111111111111112222200011
1111111111110000222222200011
1111111111110000222222200011
1100000000000000000000000011
1100000000000000000000000011
1122222220000000000022222211
1122222220000000000022222211
1122222220000000000222222211
1122222200000000222222222211
1122220000000000222222200011
1122200000000000222222200011
1111111111112222111111111111
1111111111112222111111111111
1111111111112222111111111111
1111111111112222111111111111
1111111111112222111111111111
1111111111112222111111111111